input1,input2,input3,input4,input5,input6,output1,output2
1,2,3,4,5,6,21,91
2,3,4,5,6,7,27,112
3,4,5,6,7,8,33,133
4,5,6,7,8,9,39,154
5,6,7,8,9,10,45,175
6,7,8,9,10,11,51,196
7,8,9,10,11,12,57,217
8,9,10,11,12,13,63,238
9,10,11,12,13,14,69,259
10,11,12,13,14,15,75,280
